"ad" = (/obj/effect/landmark/sokoban_crate,/turf/simulated/shuttle/floor/cargo{icon_state = "2,4"},/area/shuttle/supply/station)
"aH" = (/obj/structure/sokoban_wall,/turf/simulated/shuttle/floor/cargo{icon_state = "4,2"},/area/shuttle/supply/station)
"bb" = (/obj/structure/sokoban_target,/obj/structure/largecrate,/turf/simulated/shuttle/floor/cargo{icon_state = "0,5"},/area/shuttle/supply/station)
"bx" = (/obj/effect/landmark/sokoban_crate,/turf/simulated/shuttle/floor/cargo{icon_state = "3,2"},/area/shuttle/supply/station)
"by" = (/obj/structure/sokoban_target,/obj/effect/landmark/sokoban_crate,/turf/simulated/shuttle/floor/cargo{icon_state = "2,3"},/area/shuttle/supply/station)
"bB" = (/obj/structure/sokoban_wall,/turf/simulated/shuttle/floor/cargo{icon_state = "4,1"},/area/shuttle/supply/station)
"bG" = (/obj/structure/sokoban_wall,/turf/simulated/shuttle/floor/cargo{icon_state = "0,2"},/area/shuttle/supply/station)
"bK" = (/obj/structure/sokoban_wall,/turf/simulated/shuttle/floor/cargo{icon_state = "2,6"},/area/shuttle/supply/station)
"cj" = (/obj/structure/largecrate,/obj/effect/landmark/sokoban_crate,/turf/simulated/shuttle/floor/cargo{icon_state = "3,3"},/area/shuttle/supply/station)
"cC" = (/turf/simulated/shuttle/floor/cargo{icon_state = "0,4"},/area/shuttle/supply/station)
"cG" = (/obj/structure/sokoban_target,/turf/simulated/shuttle/floor/cargo{icon_state = "1,3"},/area/shuttle/supply/station)
"cR" = (/turf/simulated/shuttle/floor/cargo{icon_state = "2"},/area/shuttle/supply/station)
"dm" = (/turf/simulated/shuttle/floor/cargo{icon_state = "3,2"},/area/shuttle/supply/station)
"dp" = (/obj/structure/sokoban_target,/obj/effect/landmark/sokoban_crate,/turf/simulated/shuttle/floor/cargo{icon_state = "2,1"},/area/shuttle/supply/station)
"dI" = (/obj/structure/sokoban_target,/obj/structure/largecrate,/obj/effect/landmark/sokoban_crate,/turf/simulated/shuttle/floor/cargo{icon_state = "4,3"},/area/shuttle/supply/station)
"dT" = (/obj/structure/largecrate,/turf/simulated/shuttle/floor/cargo{icon_state = "0,4"},/area/shuttle/supply/station)
"eb" = (/obj/effect/landmark/sokoban_crate,/turf/simulated/shuttle/floor/cargo{icon_state = "4,2"},/area/shuttle/supply/station)
"eC" = (/obj/effect/landmark/sokoban_crate,/turf/simulated/shuttle/floor/cargo{icon_state = "3,1"},/area/shuttle/supply/station)
"fe" = (/obj/structure/sokoban_target,/obj/effect/landmark/sokoban_crate,/turf/simulated/shuttle/floor/cargo{icon_state = "3,4"},/area/shuttle/supply/station)
"gT" = (/obj/effect/landmark/sokoban_crate,/turf/simulated/shuttle/floor/cargo{icon_state = "4,1"},/area/shuttle/supply/station)
"ha" = (/obj/structure/largecrate,/obj/effect/landmark/sokoban_crate,/turf/simulated/shuttle/floor/cargo{icon_state = "0,6"},/area/shuttle/supply/station)
"hE" = (/obj/structure/sokoban_target,/turf/simulated/shuttle/floor/cargo{icon_state = "4,4"},/area/shuttle/supply/station)
"hV" = (/obj/structure/largecrate,/obj/effect/landmark/sokoban_crate,/turf/simulated/shuttle/floor/cargo{icon_state = "0,2"},/area/shuttle/supply/station)
"iy" = (/obj/structure/largecrate,/obj/effect/landmark/sokoban_crate,/turf/simulated/shuttle/floor/cargo{icon_state = "3,5"},/area/shuttle/supply/station)
"iH" = (/obj/effect/landmark/sokoban_crate,/turf/simulated/shuttle/floor/cargo{icon_state = "1,1"},/area/shuttle/supply/station)
"iJ" = (/obj/effect/landmark/sokoban_crate,/turf/simulated/shuttle/floor/cargo{icon_state = "0,2"},/area/shuttle/supply/station)
"jj" = (/obj/structure/largecrate,/turf/simulated/shuttle/floor/cargo{icon_state = "0,6"},/area/shuttle/supply/station)
"jp" = (/obj/structure/sokoban_target,/obj/effect/landmark/sokoban_crate,/turf/simulated/shuttle/floor/cargo{icon_state = "4,3"},/area/shuttle/supply/station)
"jQ" = (/turf/simulated/shuttle/floor/cargo{icon_state = "2,3"},/area/shuttle/supply/station)
"kx" = (/obj/machinery/light{dir = 4},/obj/structure/sokoban_wall,/turf/simulated/shuttle/floor/cargo{icon_state = "4,6"},/area/shuttle/supply/station)
"kH" = (/turf/simulated/shuttle/floor/cargo{icon_state = "0,2"},/area/shuttle/supply/station)
"li" = (/obj/structure/sokoban_target,/obj/effect/landmark/sokoban_crate,/turf/simulated/shuttle/floor/cargo{icon_state = "3,2"},/area/shuttle/supply/station)
"lm" = (/turf/simulated/shuttle/floor/cargo{icon_state = "1,2"},/area/shuttle/supply/station)
"lq" = (/obj/structure/sokoban_wall,/turf/simulated/shuttle/floor/cargo{icon_state = "2,1"},/area/shuttle/supply/station)
"lS" = (/obj/structure/sokoban_wall,/turf/simulated/shuttle/floor/cargo{icon_state = "4,3"},/area/shuttle/supply/station)
"mn" = (/obj/machinery/light{dir = 8},/obj/structure/sokoban_target,/obj/effect/landmark/sokoban_crate,/turf/simulated/shuttle/floor/cargo,/area/shuttle/supply/station)
"mo" = (/obj/effect/landmark/sokoban_crate,/turf/simulated/shuttle/floor/cargo{icon_state = "0,3"},/area/shuttle/supply/station)
"mA" = (/turf/simulated/shuttle/floor/cargo{icon_state = "3,1"},/area/shuttle/supply/station)
"mX" = (/obj/structure/sokoban_target,/turf/simulated/shuttle/floor/cargo{icon_state = "4,5"},/area/shuttle/supply/station)
"nq" = (/obj/effect/landmark/sokoban_crate,/turf/simulated/shuttle/floor/cargo{icon_state = "4,5"},/area/shuttle/supply/station)
"nP" = (/obj/structure/sokoban_wall,/turf/simulated/shuttle/floor/cargo{icon_state = "0,4"},/area/shuttle/supply/station)
"nQ" = (/obj/structure/largecrate,/turf/simulated/shuttle/floor/cargo{icon_state = "0,5"},/area/shuttle/supply/station)
"nV" = (/obj/structure/largecrate,/obj/effect/landmark/sokoban_crate,/turf/simulated/shuttle/floor/cargo{icon_state = "3,1"},/area/shuttle/supply/station)
"ot" = (/obj/structure/sokoban_wall,/turf/simulated/shuttle/floor/cargo{icon_state = "1,4"},/area/shuttle/supply/station)
"oz" = (/obj/structure/sokoban_target,/obj/effect/landmark/sokoban_crate,/turf/simulated/shuttle/floor/cargo{icon_state = "2,5"},/area/shuttle/supply/station)
"oK" = (/obj/structure/largecrate,/obj/effect/landmark/sokoban_crate,/turf/simulated/shuttle/floor/cargo{icon_state = "2,1"},/area/shuttle/supply/station)
"oU" = (/obj/effect/landmark/sokoban_crate,/turf/simulated/shuttle/floor/cargo{icon_state = "2,1"},/area/shuttle/supply/station)
"pg" = (/obj/effect/landmark/sokoban_crate,/turf/simulated/shuttle/floor/cargo{icon_state = "2,2"},/area/shuttle/supply/station)
"ph" = (/obj/structure/sokoban_wall,/turf/simulated/shuttle/floor/cargo{icon_state = "4,4"},/area/shuttle/supply/station)
"pm" = (/obj/structure/sokoban_wall,/turf/simulated/shuttle/floor/cargo{icon_state = "2,5"},/area/shuttle/supply/station)
"pn" = (/obj/structure/sokoban_wall,/turf/simulated/shuttle/floor/cargo{icon_state = "1,5"},/area/shuttle/supply/station)
"pu" = (/turf/simulated/shuttle/floor/cargo{icon_state = "3,5"},/area/shuttle/supply/station)
"pC" = (/obj/effect/landmark/sokoban_crate,/turf/simulated/shuttle/floor/cargo{icon_state = "3"},/area/shuttle/supply/station)
"pX" = (/obj/structure/sokoban_target,/obj/effect/landmark/sokoban_crate,/turf/simulated/shuttle/floor/cargo{icon_state = "1,4"},/area/shuttle/supply/station)
"qe" = (/obj/effect/landmark/sokoban_crate,/turf/simulated/shuttle/floor/cargo{icon_state = "3,4"},/area/shuttle/supply/station)
"qN" = (/obj/structure/sokoban_target,/obj/effect/landmark/sokoban_crate,/turf/simulated/shuttle/floor/cargo{icon_state = "1,5"},/area/shuttle/supply/station)
"qV" = (/obj/effect/landmark/sokoban_crate,/turf/simulated/shuttle/floor/cargo{icon_state = "0,5"},/area/shuttle/supply/station)
"rh" = (/turf/simulated/shuttle/floor/cargo{icon_state = "0,5"},/area/shuttle/supply/station)
"sf" = (/obj/structure/largecrate,/obj/effect/landmark/sokoban_crate,/turf/simulated/shuttle/floor/cargo{icon_state = "0,3"},/area/shuttle/supply/station)
"sh" = (/turf/simulated/shuttle/floor/cargo{icon_state = "3"},/area/shuttle/supply/station)
"si" = (/obj/structure/sokoban_target,/obj/effect/landmark/sokoban_crate,/turf/simulated/shuttle/floor/cargo{icon_state = "0,2"},/area/shuttle/supply/station)
"sj" = (/obj/effect/landmark/sokoban_crate,/turf/simulated/shuttle/floor/cargo{icon_state = "3,5"},/area/shuttle/supply/station)
"sv" = (/obj/structure/sokoban_target,/obj/structure/largecrate,/obj/effect/landmark/sokoban_crate,/turf/simulated/shuttle/floor/cargo{icon_state = "0,5"},/area/shuttle/supply/station)
"sN" = (/obj/structure/sokoban_wall,/turf/simulated/shuttle/floor/cargo{icon_state = "1,2"},/area/shuttle/supply/station)
"td" = (/turf/simulated/shuttle/floor/cargo{icon_state = "4,4"},/area/shuttle/supply/station)
"tf" = (/obj/structure/sokoban_wall,/turf/simulated/shuttle/floor/cargo{icon_state = "3,6"},/area/shuttle/supply/station)
"uf" = (/obj/effect/landmark/sokoban_crate,/turf/simulated/shuttle/floor/cargo{icon_state = "3,0"},/area/shuttle/supply/station)
"up" = (/obj/structure/sokoban_wall,/turf/simulated/shuttle/floor/cargo{icon_state = "4,0"},/area/shuttle/supply/station)
"uv" = (/obj/structure/sokoban_target,/turf/simulated/shuttle/floor/cargo{icon_state = "2,2"},/area/shuttle/supply/station)
"uD" = (/obj/structure/sokoban_target,/obj/structure/largecrate,/turf/simulated/shuttle/floor/cargo{icon_state = "4,3"},/area/shuttle/supply/station)
"uO" = (/turf/simulated/shuttle/floor/cargo{icon_state = "3,4"},/area/shuttle/supply/station)
"vI" = (/obj/structure/sokoban_target,/obj/structure/largecrate,/turf/simulated/shuttle/floor/cargo{icon_state = "1,5"},/area/shuttle/supply/station)
"wb" = (/obj/structure/sokoban_target,/turf/simulated/shuttle/floor/cargo{icon_state = "1,5"},/area/shuttle/supply/station)
"wg" = (/obj/structure/sokoban_wall,/turf/simulated/shuttle/floor/cargo{icon_state = "2,3"},/area/shuttle/supply/station)
"wp" = (/turf/simulated/shuttle/floor/cargo{icon_state = "3,0"},/area/shuttle/supply/station)
"wr" = (/obj/machinery/light{dir = 8},/turf/simulated/shuttle/floor/cargo{icon_state = "0,1"},/area/shuttle/supply/station)
"wD" = (/obj/structure/sokoban_wall,/turf/simulated/shuttle/floor/cargo{icon_state = "3,5"},/area/shuttle/supply/station)
"wG" = (/obj/effect/landmark/sokoban_crate,/turf/simulated/shuttle/floor/cargo{icon_state = "2,5"},/area/shuttle/supply/station)
"wM" = (/turf/simulated/shuttle/floor/cargo{icon_state = "1,5"},/area/shuttle/supply/station)
"wO" = (/obj/structure/sokoban_target,/obj/effect/landmark/sokoban_crate,/turf/simulated/shuttle/floor/cargo{icon_state = "1,3"},/area/shuttle/supply/station)
"yl" = (/turf/simulated/shuttle/floor/cargo{icon_state = "0,3"},/area/shuttle/supply/station)
"yr" = (/obj/effect/landmark/sokoban_crate,/turf/simulated/shuttle/floor/cargo{icon_state = "2"},/area/shuttle/supply/station)
"yB" = (/obj/effect/landmark/sokoban_crate,/turf/simulated/shuttle/floor/cargo{icon_state = "0,6"},/area/shuttle/supply/station)
"yN" = (/obj/effect/landmark/sokoban_crate,/turf/simulated/shuttle/floor/cargo{icon_state = "1,2"},/area/shuttle/supply/station)
"yP" = (/obj/structure/sokoban_wall,/turf/simulated/shuttle/floor/cargo{icon_state = "0,3"},/area/shuttle/supply/station)
"zf" = (/obj/structure/largecrate,/obj/effect/landmark/sokoban_crate,/turf/simulated/shuttle/floor/cargo{icon_state = "3,4"},/area/shuttle/supply/station)
"zg" = (/turf/simulated/shuttle/floor/cargo{icon_state = "2,2"},/area/shuttle/supply/station)
"zO" = (/obj/structure/largecrate,/obj/effect/landmark/sokoban_crate,/turf/simulated/shuttle/floor/cargo{icon_state = "1,2"},/area/shuttle/supply/station)
"zQ" = (/obj/structure/sokoban_target,/turf/simulated/shuttle/floor/cargo{icon_state = "4,3"},/area/shuttle/supply/station)
"zR" = (/obj/effect/landmark/sokoban_crate,/turf/simulated/shuttle/floor/cargo{icon_state = "1,3"},/area/shuttle/supply/station)
"Ab" = (/obj/structure/largecrate,/obj/effect/landmark/sokoban_crate,/turf/simulated/shuttle/floor/cargo{icon_state = "1,3"},/area/shuttle/supply/station)
"Am" = (/obj/effect/landmark/sokoban_crate,/turf/simulated/shuttle/floor/cargo{icon_state = "1,5"},/area/shuttle/supply/station)
"Ao" = (/obj/machinery/light{dir = 8},/obj/effect/landmark/sokoban_crate,/turf/simulated/shuttle/floor/cargo{icon_state = "0,1"},/area/shuttle/supply/station)
"Au" = (/obj/effect/landmark/sokoban_crate,/turf/simulated/shuttle/floor/cargo{icon_state = "0,4"},/area/shuttle/supply/station)
"AC" = (/obj/structure/sokoban_wall,/turf/simulated/shuttle/floor/cargo{icon_state = "2,2"},/area/shuttle/supply/station)
"AF" = (/obj/structure/sokoban_target,/turf/simulated/shuttle/floor/cargo{icon_state = "1,2"},/area/shuttle/supply/station)
"AI" = (/obj/machinery/light{dir = 8},/obj/structure/sokoban_wall,/turf/simulated/shuttle/floor/cargo,/area/shuttle/supply/station)
"AU" = (/obj/effect/landmark/sokoban_crate,/turf/simulated/shuttle/floor/cargo{icon_state = "1,4"},/area/shuttle/supply/station)
"AZ" = (/obj/structure/sokoban_wall,/turf/simulated/shuttle/floor/cargo{icon_state = "1,3"},/area/shuttle/supply/station)
"BD" = (/obj/structure/sokoban_wall,/turf/simulated/shuttle/floor/cargo{icon_state = "3,2"},/area/shuttle/supply/station)
"BE" = (/obj/structure/sokoban_target,/obj/effect/landmark/sokoban_crate,/turf/simulated/shuttle/floor/cargo{icon_state = "0,4"},/area/shuttle/supply/station)
"Cs" = (/obj/structure/sokoban_target,/obj/structure/largecrate,/turf/simulated/shuttle/floor/cargo{icon_state = "0,3"},/area/shuttle/supply/station)
"CC" = (/obj/structure/sokoban_target,/obj/structure/largecrate,/obj/effect/landmark/sokoban_crate,/turf/simulated/shuttle/floor/cargo{icon_state = "0,3"},/area/shuttle/supply/station)
"Da" = (/obj/structure/sokoban_wall,/turf/simulated/shuttle/floor/cargo{icon_state = "3,1"},/area/shuttle/supply/station)
"Et" = (/obj/machinery/light{dir = 8},/obj/structure/sokoban_wall,/turf/simulated/shuttle/floor/cargo{icon_state = "0,1"},/area/shuttle/supply/station)
"Ex" = (/obj/structure/sokoban_target,/turf/simulated/shuttle/floor/cargo{icon_state = "2"},/area/shuttle/supply/station)
"EC" = (/obj/structure/sokoban_target,/turf/simulated/shuttle/floor/cargo{icon_state = "3,2"},/area/shuttle/supply/station)
"EO" = (/obj/structure/sokoban_target,/obj/structure/largecrate,/turf/simulated/shuttle/floor/cargo{icon_state = "0,4"},/area/shuttle/supply/station)
"Fd" = (/turf/simulated/shuttle/floor/cargo{icon_state = "4,1"},/area/shuttle/supply/station)
"Fm" = (/turf/simulated/shuttle/floor/cargo{icon_state = "4,0"},/area/shuttle/supply/station)
"Fy" = (/obj/structure/sokoban_wall,/turf/simulated/shuttle/floor/cargo{icon_state = "3,0"},/area/shuttle/supply/station)
"FQ" = (/obj/structure/sokoban_target,/obj/effect/landmark/sokoban_crate,/turf/simulated/shuttle/floor/cargo{icon_state = "4,4"},/area/shuttle/supply/station)
"Gp" = (/obj/effect/landmark/sokoban_crate,/turf/simulated/shuttle/floor/cargo{icon_state = "4,0"},/area/shuttle/supply/station)
"Gv" = (/obj/effect/landmark/sokoban_crate,/turf/simulated/shuttle/floor/cargo{icon_state = "4,4"},/area/shuttle/supply/station)
"GR" = (/obj/structure/largecrate,/turf/simulated/shuttle/floor/cargo{icon_state = "0,3"},/area/shuttle/supply/station)
"GX" = (/obj/structure/largecrate,/turf/simulated/shuttle/floor/cargo{icon_state = "1,5"},/area/shuttle/supply/station)
"Ho" = (/obj/structure/sokoban_target,/obj/effect/landmark/sokoban_crate,/turf/simulated/shuttle/floor/cargo{icon_state = "4,5"},/area/shuttle/supply/station)
"HW" = (/obj/effect/landmark/sokoban_crate,/turf/simulated/shuttle/floor/cargo{icon_state = "2,3"},/area/shuttle/supply/station)
"Jw" = (/obj/effect/landmark/sokoban_crate,/turf/simulated/shuttle/floor/cargo{icon_state = "3,6"},/area/shuttle/supply/station)
"Ki" = (/obj/structure/sokoban_wall,/turf/simulated/shuttle/floor/cargo{icon_state = "4,5"},/area/shuttle/supply/station)
"Kp" = (/obj/structure/sokoban_target,/turf/simulated/shuttle/floor/cargo{icon_state = "0,2"},/area/shuttle/supply/station)
"Kr" = (/obj/effect/landmark/sokoban_crate,/turf/simulated/shuttle/floor/cargo{icon_state = "4,3"},/area/shuttle/supply/station)
"KN" = (/obj/structure/sokoban_target,/obj/effect/landmark/sokoban_crate,/turf/simulated/shuttle/floor/cargo{icon_state = "1,1"},/area/shuttle/supply/station)
"Lc" = (/obj/effect/landmark/sokoban_crate,/turf/simulated/shuttle/floor/cargo{icon_state = "3,3"},/area/shuttle/supply/station)
"LT" = (/obj/structure/sokoban_target,/obj/effect/landmark/sokoban_crate,/turf/simulated/shuttle/floor/cargo{icon_state = "3,3"},/area/shuttle/supply/station)
"Mc" = (/obj/structure/sokoban_wall,/turf/simulated/shuttle/floor/cargo{icon_state = "1,1"},/area/shuttle/supply/station)
"Mq" = (/obj/structure/sokoban_wall,/turf/simulated/shuttle/floor/cargo{icon_state = "3,4"},/area/shuttle/supply/station)
"MI" = (/turf/simulated/shuttle/floor/cargo{icon_state = "2,5"},/area/shuttle/supply/station)
"Ng" = (/turf/simulated/shuttle/floor/cargo{icon_state = "1,3"},/area/shuttle/supply/station)
"Od" = (/obj/structure/sokoban_wall,/turf/simulated/shuttle/floor/cargo{icon_state = "3"},/area/shuttle/supply/station)
"Of" = (/obj/structure/sokoban_target,/obj/effect/landmark/sokoban_crate,/turf/simulated/shuttle/floor/cargo{icon_state = "3,1"},/area/shuttle/supply/station)
"Oj" = (/obj/structure/sokoban_wall,/turf/simulated/shuttle/floor/cargo{icon_state = "2,4"},/area/shuttle/supply/station)
"OG" = (/obj/structure/largecrate,/turf/simulated/shuttle/floor/cargo{icon_state = "4,3"},/area/shuttle/supply/station)
"OO" = (/obj/structure/largecrate,/obj/effect/landmark/sokoban_crate,/turf/simulated/shuttle/floor/cargo{icon_state = "0,4"},/area/shuttle/supply/station)
"OY" = (/obj/machinery/light{dir = 4},/obj/effect/landmark/sokoban_crate,/turf/simulated/shuttle/floor/cargo{icon_state = "4,6"},/area/shuttle/supply/station)
"Pa" = (/obj/structure/sokoban_wall,/turf/simulated/shuttle/floor/cargo{icon_state = "0,6"},/area/shuttle/supply/station)
"Pf" = (/obj/structure/largecrate,/obj/effect/landmark/sokoban_crate,/turf/simulated/shuttle/floor/cargo{icon_state = "1,5"},/area/shuttle/supply/station)
"Pj" = (/obj/structure/sokoban_target,/turf/simulated/shuttle/floor/cargo{icon_state = "1,4"},/area/shuttle/supply/station)
"Px" = (/obj/structure/sokoban_target,/turf/simulated/shuttle/floor/cargo{icon_state = "0,4"},/area/shuttle/supply/station)
"PB" = (/obj/machinery/light{dir = 4},/obj/structure/sokoban_wall,/turf/simulated/shuttle/floor/cargo{icon_state = "1,6"},/area/shuttle/supply/station)
"PC" = (/obj/structure/sokoban_wall,/turf/simulated/shuttle/floor/cargo{icon_state = "3,3"},/area/shuttle/supply/station)
"Qi" = (/obj/structure/largecrate,/turf/simulated/shuttle/floor/cargo{icon_state = "1,3"},/area/shuttle/supply/station)
"Re" = (/turf/simulated/shuttle/floor/cargo{icon_state = "4,5"},/area/shuttle/supply/station)
"Sr" = (/obj/structure/sokoban_wall,/turf/simulated/shuttle/floor/cargo{icon_state = "2"},/area/shuttle/supply/station)
"SH" = (/obj/structure/largecrate,/obj/effect/landmark/sokoban_crate,/turf/simulated/shuttle/floor/cargo{icon_state = "3,2"},/area/shuttle/supply/station)
"SP" = (/turf/simulated/shuttle/floor/cargo{icon_state = "2,4"},/area/shuttle/supply/station)
"Tw" = (/obj/structure/largecrate,/obj/effect/landmark/sokoban_crate,/turf/simulated/shuttle/floor/cargo{icon_state = "4,3"},/area/shuttle/supply/station)
"TG" = (/obj/machinery/light{dir = 4},/turf/simulated/shuttle/floor/cargo{icon_state = "4,6"},/area/shuttle/supply/station)
"UC" = (/obj/structure/sokoban_target,/obj/effect/landmark/sokoban_crate,/turf/simulated/shuttle/floor/cargo{icon_state = "2,2"},/area/shuttle/supply/station)
"UF" = (/obj/structure/largecrate,/obj/effect/landmark/sokoban_crate,/turf/simulated/shuttle/floor/cargo{icon_state = "0,5"},/area/shuttle/supply/station)
"Vd" = (/obj/effect/landmark/sokoban_crate,/turf/simulated/shuttle/floor/cargo{icon_state = "2,6"},/area/shuttle/supply/station)
"VD" = (/obj/structure/sokoban_target,/obj/effect/landmark/sokoban_crate,/turf/simulated/shuttle/floor/cargo{icon_state = "2,4"},/area/shuttle/supply/station)
"VW" = (/turf/simulated/shuttle/floor/cargo{icon_state = "1,4"},/area/shuttle/supply/station)
"Wa" = (/obj/structure/sokoban_target,/obj/structure/largecrate,/obj/effect/landmark/sokoban_crate,/turf/simulated/shuttle/floor/cargo{icon_state = "3,2"},/area/shuttle/supply/station)
"WW" = (/turf/simulated/shuttle/floor/cargo{icon_state = "2,1"},/area/shuttle/supply/station)
"Xk" = (/obj/structure/sokoban_target,/obj/structure/largecrate,/obj/effect/landmark/sokoban_crate,/turf/simulated/shuttle/floor/cargo{icon_state = "3,4"},/area/shuttle/supply/station)
"Xn" = (/turf/simulated/shuttle/floor/cargo{icon_state = "0,6"},/area/shuttle/supply/station)
"XH" = (/obj/structure/largecrate,/turf/simulated/shuttle/floor/cargo{icon_state = "3,3"},/area/shuttle/supply/station)
"Zb" = (/turf/simulated/shuttle/floor/cargo{icon_state = "4,3"},/area/shuttle/supply/station)
"Zj" = (/obj/machinery/light{dir = 8},/obj/effect/landmark/sokoban_crate,/turf/simulated/shuttle/floor/cargo,/area/shuttle/supply/station)
"Zp" = (/obj/structure/sokoban_wall,/turf/simulated/shuttle/floor/cargo{icon_state = "0,5"},/area/shuttle/supply/station)
"ZU" = (/turf/simulated/shuttle/floor/cargo{icon_state = "4,2"},/area/shuttle/supply/station)

(1,1,1) = {"
wrnqZUVWtdgTkxEtKiZUAUtdbBkxEtReZUVWtdbBkxEtKiZUpXphbBkxAomXZUPjphgTOY
GpsNQicCGXyBtfupsNAbnPGXPatfupyNAZdTwMhaJwupsNzRAupnPatfGpsNNgcCpnhaJw
ufkHmoZbnQlqOdFysiyluDrhdpOdFykHylKrrhoUpCFybGCCKrqVoUOdufkHmoKrrhoKpC
ExeCBDPCqesjbKSreCbxLcqesjbKyreCBDPCMqiybKSrDabxLczfsjbKSrDabxLcMqwDbK
AIiHUCjQVDwGPBAIiHpgwgadwGPBZjiHuvbyVDMIPBAIMcpgHWOjpmPBAIMcACwgOjpmPB
EtHoebAUphbBkxEtReZUAUhEbBkxEtReZUAUphbBkxEtKiaHVWtdgTkxwrReZUVWGvgTkx
upyNAbOOAmPatfupyNAZnPwMPatfupyNNgAupnPatfupsNAZdTGXyBtfFmzOwOdTqNyBtf
FybGmoKrqVlqOdFyiJmoTwUFoUOdFyiJsfOGZplqOdFykHmoZbZplqOdwpKpGRzQnQWWOd
SrDaBDLcqewDbKSrmABDLcqesjbKSrDaliLcfesjbKSreCbxLcqesjbKyrnVECcjfepubK
AIMcACwgVDpmPBAIKNpgHWOjpmPBAIMcpgHWadwGPBAIiHUCHWVDwGPBZjiHzgjQSPwGPB
EtnqZUVWtdFdkxEtKiZUVWtdbBkxEtnqZUottdFdkxEtKiZUAUtdbBkxEtnqZUPjFQFdTG
upyNNgnPAmXntfGplmNgnPAmXntfupAFAbdTPfyBtfupyNQiAuGXyBtfupyNAbEOvIjjJw
FybGGROGnQlqOdufbGCCKrZpoUOdFysimolSqVoUOdFyiJyllSrhoUOdFybGmoKrqVoUOd
SreCbxLcqesjbKyreCdmXHMqsjbKSrOfbxLcqesjbKSreCWaLcXkpubKSrDabxLcqesjbK
AIKNpgbyadozPBAIMcUCHWadwGPBAIMcACwgOjpmPBAIMcUCHWVDpmPBAIMcACwgOjpmPB
EtKiaHottdFdOYEtReZUottdFdkxEtnqZUAUtdFdkxAomXZUVWphbBkxEtKiZUVWtdbBkx
upsNNgAuGXPaJwupyNAZnPAmXntfupyNAZAupnyBtfGplmAZAupnPatfupsNAbBEGXyBtf
FyiJGRZbbboUpCFykHsfZbnQWWpCFysimoTwsvoUOdwpsiyPOGUFoUpCFyiJsfjpqVoUOd
SreCBDLTfesjbKyreCbxXHqesjVdSreCbxLcMqwDbKcReCdmLcuOsjVdSreCbxLTqesjbK
AIiHpgHWOjpmPBmnKNUCwgOjpmPBAIMcACwgOjpmPBZjiHACwgOjpmPBAIMcACwgOjpmPB
EtnqebVWtdbBkxEtKiaHVWtdFdOYEtKiaHVWtdFdkxEtKiZUAUphbBkxEtKiaHottdgTkx
upyNwOAuvIPatfupsNAZcCwbPaJwuplmcGPxpnyBtfGpyNNgcCwMyBJwGpyNNgcCwMXntf
FyiJmoTwqVoUOdFyiJmoTwsvoUshufiJCCZbUFoUOdufhVyluDbbdppCufsiCsdIUFoUOd
SrDaBDLcqesjbKSreCbxLcqewDbKyrDaSHLcqewDbKyreCBDPCuOsjVdyreCdmLcqesjbK
AIMcACwgOjpmPBAIiHpgwgOjpmPBZjiHpgwgOjpmPBAIMcACwgOjpmPBAIMcACwgOjpmPB
"}
